50
MMMMMMMMMMMMMMMMMMMMMMMMMMMMMMMMMMMMMMMMMMMMMMMMMM
MMMMMMMMMMMMMMMMMMMMMMMMMMMMMMMMMMMMMMMMMMMMMMMMMM
MMMMMMMMMMMMMMMMMMMMMMMMMMMMMMMMMMMMMMMMMMMMMMMMMM
MMMMMMMMMMMMMMMMMMMMMMMMMMMMMMMMMMMMMMMMMMMMMMMMMM
MMMMMMMMMMMMMMMMMMMMMMMMMMMMMMMMMMMMMMMMMMMMMMMMMM
MMMMMMMMMMMMMMMMMMMMMMMMMMMMMMMMMMMMMMMMMMMMMMMMMM
MMMMMMMMMMMMMMMMMMMMMMMMMMMMMMMMMMMMMMMMMMMMMMMMMM
MMMMMMMMMMMMMMMMMMMMMMMMMMMMMMMMMMMMMMMMMMMMMMMMMM
MMMMMMMMMMMMMMMMMMMMMMMMMMMMMMMMMMMMMMMMMMMMMMMMMM
MMMMMMMMMMMMMMMMMMMMMMMMMMMMMMMMMMMMMMMMMMMMMMMMMM
MMMMMMMMMMMMMMMMMMMMMMMMMMMMMMMMMMMMMMMMMMMMMMMMMM
MMMMMMMMMMMMMMMMMMMMMMMMMMMMMMMMMMMMMMMMMMMMMMMMMM
MMMMMMMMMMMMMMMMMMMMMMMMMMMMMMMMMMMMMMMMMMMMMMMMMM
MMMMMMMMMMMMMMMMMMMMMMMMMMMMMMMMMMMMMMMMMMMMMMMMMM
MMMMMMMMMMMMMMMMMMMMMMMMMMMMMMMMMMMMMMMMMMMMMMMMMM
MMMMMMMMMMMMMMMMMM#!===MMMMMMMMMMMMMMMMMMMMMMMMMMM
MMMMMMMMMMMMMMMMM}======MMMMMMMMMMMMMMMMMMMMMMMMMM
MMMMMMMMMMMMMMMMM=======MMMMMMMMMMMMMMMMMMMMMMMMMM
MMMMMMMMMMMMM#"MHD======WMHMMMMMMMMMMMMMMMMMMMMMMM
MMMMMMMD========================= ?7UMMMMMMMMMMMMM
MMMMM#================================TMMMMMMMMMMM
MMMMMN ================================?MMMMMMMMMM
MMMMMMNm================================MMMMMMMMMM
MMMMMMMMMMMMMMMMk========NJ+a=&+ggggggMMMMMMMMMMMM
MMMMMMMMMMMMMMMMM[=======MMMMMMMMY"MMMMMMMMMMMMMMM
MMMMMMMMMMMMMMMMM#=======_"?T"T"=====MMMMMMMMMMMMM
MMMMMMMMMMMMMM#B=====================?TMMMMMMMMMMM
MMMMMMMMMMMM^============================WMMMMMMMM
MMMMMMMMMMD ==============J================MMMMMMM
MMMMMMMMM^================MM#===============MMMMMM
MMMMMMMMF=======JMb=======MM3======N======= MMMMMM
MMMMMMMMt======dMMMN =====(=======MMb=======MMMMMM
MMMMMMMM}======MMMMM=========== JMMMF=======MMMMMM
MMMMMMMMN======TMMM#t==========dMM#^====== dMMMMMM
MMMMMMMMMb ==================MMMMM_====== JMMMMMMM
MMMMMMMMMMNg=================(MMMMN====+MMMMMMMMMM
MMMMMMMMMMMMMMMMNagMMMMN====JMMMMMMMMMMMMMMMMMMMMM
MMMMMMMMMMMMMMMMMMMMMMMMMMMMMMMMMMMMMMMMMMMMMMMMMM
MMMMMMMMMMMMMMMMMMMMMMMMMMMMMMMMMMMMMMMMMMMMMMMMMM
MMMMMMMMMMMMMMMMMMMMMMMMMMMMMMMMMMMMMMMMMMMMMMMMMM
MMMMMMMMMMMMMMMMMMMMMMMMMMMMMMMMMMMMMMMMMMMMMMMMMM
MMMMMMMMMMMMMMMMMMMMMMMMMMMMMMMMMMMMMMMMMMMMMMMMMM
MMMMMMMMMMMMMMMMMMMMMMMMMMMMMMMMMMMMMMMMMMMMMMMMMM
MMMMMMMMMMMMMMMMMMMMMMMMMMMMMMMMMMMMMMMMMMMMMMMMMM
MMMMMMMMMMMMMMMMMMMMMMMMMMMMMMMMMMMMMMMMMMMMMMMMMM
MMMMMMMMMMMMMMMMMMMMMMMMMMMMMMMMMMMMMMMMMMMMMMMMMM
MMMMMMMMMMMMMMMMMMMMMMMMMMMMMMMMMMMMMMMMMMMMMMMMMM
MMMMMMMMMMMMMMMMMMMMMMMMMMMMMMMMMMMMMMMMMMMMMMMMMM
MMMMMMMMMMMMMMMMMMMMMMMMMMMMMMMMMMMMMMMMMMMMMMMMMM
MMMMMMMMMMMMMMMMMMMMMMMMMMMMMMMMMMMMMMMMMMMMMMMMMM