9
.........
.........
....$....
...$.$...
..$...$..
.$$$$$$$.
$.......$
.........
.........
