49
MMMMMMMMMMMMMMMMMMMMMMMMMMMMMMMMMMMMMMMMMMMMMMMMM
MMMMMMMMMMMMMMMMMMMMMMMMMMMMMMMMMMMMMMMMMMMMMMMMM
MMMMMMMMMMMMMMMMMMMMMMMMMMMMMMMMMMMMMMMMMMMMMMMMM
MMMMMMMMMMMMMMMMMMMMMMMMMMMMMMMMMMMMMMMMMMMMMMMMM
MMMMMMMMMMMMMMMMMMMMMMMMMMMMMMMMMMMMMMMMMMMMMMMMM
MMMMMMMMMMMMMMMMMMMMMMMMMMMMMMMMMMMMMMMMMMMMMMMMM
MMMMMMMMMMMMMMMMMMMMMMMMMMMMMMMMMMMMMMMMMMMMMMMMM
MMMMMMMMMMMMMMMMMMMMMMMMMMMMMMMMMMMMMMMMMMMMMMMMM
MMMMMMMMMMMMMMMMMMMMMMMMMMMMMMMMMMMMMMMMMMMMMMMMM
MMMMMMMMMMMMMMMMMMMMMMMMMMMMMMMMMMMMMMMMMMMMMMMMM
MMMMMMMMMMMMMMMMMMMMMMMMMMMMMMMMMMMMMMMMMMMMMMMMM
MMMMMMMMMMMMMMMMMMMMMMMMMMMMMMMMMMMMMMMMMMMMMMMMM
MMMMMMMMMMMMMMMMMMMMMMMMMMMMMMMMMMMMMMMMMMMMMMMMM
MMMMMMMMMMMMMMMMMMMMMMMMMMMMMMMMMMMMMMMMMMMMMMMMM
MMMMMMMMMMMMMMMMMM#!``,MMMMMMMMMMMMMMMMMMMMMMMMMM
MMMMMMMMMMMMMMMMM}```.`,MMMMMMMMMMMMMMMMMMMMMMMMM
MMMMMMMMMMMMMMMMM'`.```.MMMMMMMMMMMMMMMMMMMMMMMMM
MMMMMMMMMMMMM#"MHD``.``.WMHMMMMMMMMMMMMMMMMMMMMMM
MMMMMMMD`````````````.``````````` ?7UMMMMMMMMMMMM
MMMMM#.`.``.``.`.``.```.`.``.`.``````.TMMMMMMMMMM
MMMMMN ``.``.``.``.```.```.``.`.``.````?MMMMMMMMM
MMMMMMNm.````.``````````````````.````.`.MMMMMMMMM
MMMMMMMMMMMMMMMMk..`..``.NJ+a.&+ggggggMMMMMMMMMMM
MMMMMMMMMMMMMMMMM[````...MMMMMMMMY"MMMMMMMMMMMMMM
MMMMMMMMMMMMMMMMM#```````_"?T"T"````.MMMMMMMMMMMM
MMMMMMMMMMMMMM#B=``.`.```````````.```?TMMMMMMMMMM
MMMMMMMMMMMM^```````.``.``..`.``.``.```..WMMMMMMM
MMMMMMMMMMD ``.```.````.`.J.,.````.`..````,MMMMMM
MMMMMMMMM^```.`.`..``.```.MM#`.`.``````.```.MMMMM
MMMMMMMMF`.`.``.JMb````.`.MM3```.`.N.```.`` MMMMM
MMMMMMMMt``.```dMMMN ```.`('```.`.MMb`.````.MMMMM
MMMMMMMM}````.,MMMMM,`.```.``.` JMMMF``.```.MMMMM
MMMMMMMMN..````TMMM#t```.````..dMM#^````.` dMMMMM
MMMMMMMMMb .```.````.``.``.`.MMMMM_``.``` JMMMMMM
MMMMMMMMMMNg.`.``.```..````.`(MMMMN,...+MMMMMMMMM
MMMMMMMMMMMMMMMMNagMMMMN.,..JMMMMMMMMMMMMMMMMMMMM
MMMMMMMMMMMMMMMMMMMMMMMMMMMMMMMMMMMMMMMMMMMMMMMMM
MMMMMMMMMMMMMMMMMMMMMMMMMMMMMMMMMMMMMMMMMMMMMMMMM
MMMMMMMMMMMMMMMMMMMMMMMMMMMMMMMMMMMMMMMMMMMMMMMMM
MMMMMMMMMMMMMMMMMMMMMMMMMMMMMMMMMMMMMMMMMMMMMMMMM
MMMMMMMMMMMMMMMMMMMMMMMMMMMMMMMMMMMMMMMMMMMMMMMMM
MMMMMMMMMMMMMMMMMMMMMMMMMMMMMMMMMMMMMMMMMMMMMMMMM
MMMMMMMMMMMMMMMMMMMMMMMMMMMMMMMMMMMMMMMMMMMMMMMMM
MMMMMMMMMMMMMMMMMMMMMMMMMMMMMMMMMMMMMMMMMMMMMMMMM
MMMMMMMMMMMMMMMMMMMMMMMMMMMMMMMMMMMMMMMMMMMMMMMMM
MMMMMMMMMMMMMMMMMMMMMMMMMMMMMMMMMMMMMMMMMMMMMMMMM
MMMMMMMMMMMMMMMMMMMMMMMMMMMMMMMMMMMMMMMMMMMMMMMMM
MMMMMMMMMMMMMMMMMMMMMMMMMMMMMMMMMMMMMMMMMMMMMMMMM
MMMMMMMMMMMMMMMMMMMMMMMMMMMMMMMMMMMMMMMMMMMMMMMMM